// Needs Windows 1803+

<AppConfig Executable="C:\Program Files 
  (x86)\Google\Chrome\Application\chrome.exe"> <DEP Enable="true" 
  EmulateAtlThunks="false" /> <ASLR ForceRelocateImages="true" 
  RequireInfo="true" BottomUp="true" HighEntropy="true" /> 
  <StrictHandle Enable="true" /> <ExtensionPoints 
  DisableExtensionPoints="true" /> <ControlFlowGuard Enable="true" 
  SuppressExports="false" /> <SignedBinaries 
  EnforceModuleDependencySigning="true" /> <Fonts 
  DisableNonSystemFonts="true" AuditOnly="false" Audit="false" /> 
  <ImageLoad BlockRemoteImageLoads="true" AuditRemoteImageLoads="false" 
  BlockLowLabelImageLoads="true" AuditLowLabelImageLoads="false" /> 
  <Payload EnableImportAddressFilter="false" 
  EnableRopSimExec="false" /> <SEHOP Enable="true" 
  TelemetryOnly="false" /> <Heap TerminateOnError="true" /> 

// Coresponding to Firefox!
  <AppConfig Executable="C:\Program Files\Mozilla Firefox\firefox.exe"> 
    <DEP Enable="true" EmulateAtlThunks="false" /> 
    <ASLR ForceRelocateImages="true" RequireInfo="true" BottomUp="true" 
  HighEntropy="true" /> <StrictHandle Enable="true" /> 
    <ExtensionPoints DisableExtensionPoints="true" /> 
    <ControlFlowGuard Enable="true" SuppressExports="false" /> 
    <SignedBinaries EnforceModuleDependencySigning="true" /> 
    <Fonts DisableNonSystemFonts="true" AuditOnly="false" 
  Audit="false" /> <ImageLoad BlockRemoteImageLoads="true" 
  AuditRemoteImageLoads="false" BlockLowLabelImageLoads="true" 
  AuditLowLabelImageLoads="false" /> <Payload 
  EnableExportAddressFilter="true" 
  AuditEnableExportAddressFilter="false" 
  EnableExportAddressFilterPlus="true" 
  AuditEnableExportAddressFilterPlus="false" 
  EnableImportAddressFilter="true" 
  AuditEnableImportAddressFilter="false" EnableRopStackPivot="true" 
  AuditEnableRopStackPivot="false" EnableRopCallerCheck="true" 
  AuditEnableRopCallerCheck="false" EnableRopSimExec="true" 
  AuditEnableRopSimExec="false" /> <SEHOP Enable="true" 
  TelemetryOnly="false" /> <Heap TerminateOnError="true" /> </AppConfig> 